万恶之源
12 12
12
255 126 0   130 130 130   0 183 239   139 0 139   199 26 35   77 109 243   255 163 177   94 51 33   245 76 245   255 242 0   14 125 45   165 230 122

0 1   0   2   0   3   0   4   5   0   0   6
0 7   8   0   4   1   4   7   0   8   9   5
1 4   0   10 2   5   5   0   5   0   0   4
3 11 0   9   2   8   4   5   0   10 3   5
0 5   4   2   6   0   6   0   4   0   5   0
4 0   6   5   1   3   9   7   7   11 10 2
5 7   4   11 10 9   7   0   10 2   0   7
0 4   11 10 0   11 10 11 11 1   4   5
8 9   7   3   9   4   0   10 4   10 11 8
4 6   10 0   10 7   7   11 10 0   4   7
5 11 4   9   8   0   10 10 1   2   9   0
0 8   5   4   9   4   0   8   4   6   2   0

5   1   3   6   5   1   2   3   3   11 5   4
12 5   6   12 4   5   7   5   13 6   2   6
3   3   18 6   11 14 14 11 14 14 3   8
1   4   18 5   10 7   10 11 15 3   2   7
6   4   6   12 13 10 16 4   15 14 1   3
8   3   6   7   10 5   3   8   9   6   4   5
4   5   9   8   6   19 5   6   6   1   11 6
3   8   7   5   4   16 4   9   5   4   12 5
5   7   3   4   4   4   3   6   3   6   6   5
18 3   10 2   6   4   3   3   6   3   11 10
6   3   16 3   6   1   7   4   6   11 3   8
3   10 5   4   6   4   7   9   15 6   6   6

0   0   0   0   0   0   0   0   0   0   0   0
0   0   0   0   0   2   5   5   0   0   0   0
0   0   0   0   2   5   5   5   5   0   0   0
0   0   0   0   2   5   5   5   5   0   0   0
0   0   0   0   2   6   6   6   0   0   0   0
0   0   0   0   1   6   6   6   0   0   0   0
4   4   4   4   1   6   6   7   4   7   4   4
4   4   4   11 11 9   9   11 7   7   4   4
4   4   10 11 9   9   9   9   11 10 4   4
4   4   10 11 11 11 11 11 11 10 4   4
4   4   10 10 10 7   7   10 10 10 4   4
4   4   10 10 10 10 10 10 10 10 4   4

CBABABCBCBCBCBABBABABBABCBABRBBBA